∎∎∎∎∎∎∎∎∎∎∎∎∎∎∎∎∎∎∎∎∎∎∎∎∎∎∎∎∎∎∎∎∎∎∎∎∎∎∎∎∎
∎··········∎∎·······●·······∎∎··········∎
∎●∎∎∎·∎∎∎∎·∎∎·∎·∎∎∎∎∎∎∎∎∎·∎·∎∎·∎∎∎∎·∎∎∎●∎
∎·∎···∎∎······∎···········∎······∎∎···∎·∎
∎·∎·∎····∎∎∎∎∎∎∎∎∎∎∎·∎∎∎∎∎∎∎∎∎∎∎····∎·∎·∎
∎···∎·∎∎······∎           ∎······∎∎·∎···∎
∎∎∎∎∎·∎∎·∎∎∎∎·∎ ∎∎∎   ∎∎∎ ∎·∎∎∎∎·∎∎·∎∎∎∎∎
·········∎∎∎∎·· ∎       ∎ ··∎∎∎∎·········
∎∎∎∎∎·∎∎······∎ ∎∎∎∎∎∎∎∎∎ ∎······∎∎·∎∎∎∎∎
∎···∎·∎∎·∎∎∎∎·∎           ∎·∎∎∎∎·∎∎·∎···∎
∎·∎·∎····∎∎∎∎·∎·∎∎∎∎∎∎∎∎∎·∎·∎∎∎∎····∎·∎·∎
∎·∎···∎∎∎∎····∎·····∎·····∎····∎∎∎∎···∎·∎
∎●∎∎∎·∎∎∎∎·∎∎·∎∎∎∎∎·∎·∎∎∎∎∎·∎∎·∎∎∎∎·∎∎∎●∎
∎··········∎∎·······●·······∎∎··········∎
∎∎∎∎∎∎∎∎∎∎∎∎∎∎∎∎∎∎∎∎∎∎∎∎∎∎∎∎∎∎∎∎∎∎∎∎∎∎∎∎∎